Team,Conference,Season,Games,RushingYds,RushingTDs,PassingYds,PassingTDs,OffensiveYards,Turnovers
Air Force,Mountain West Conference,2018,12,3404,33,1576,10,4980,15
Akron,Mid-American Conference,2018,12,1178,5,2390,16,3568,24
Alabama,Southeastern Conference,2018,15,2976,33,4854,52,7830,15
Appalachian State,Sun Belt Conference,2018,13,3125,31,2478,27,5603,17
Arizona,Pac-12 Conference,2018,12,2429,14,3063,29,5492,19
Arizona State,Pac-12 Conference,2018,13,2395,26,3025,20,5420,11
Arkansas,Southeastern Conference,2018,12,1720,11,2301,17,4021,26
Arkansas State,Sun Belt Conference,2018,13,2418,18,3659,28,6077,16
Army,Independent,2018,13,4062,47,1041,7,5103,8
Auburn,Southeastern Conference,2018,13,2177,25,2892,21,5069,13
Ball State,Mid-American Conference,2018,12,1874,20,3035,17,4909,22
Baylor,Big 12 Conference,2018,13,2198,25,3770,22,5968,19
Boise State,Mountain West Conference,2018,13,2178,24,3796,31,5974,13
Boston College,Atlantic Coast Conference,2018,12,2270,23,2583,25,4853,19
Bowling Green State,Mid-American Conference,2018,12,1417,9,2864,28,4281,22
Buffalo,Mid-American Conference,2018,14,2654,36,3155,28,5809,20
BYU,Independent,2018,13,1995,27,2753,18,4748,17
California,Pac-12 Conference,2018,13,2050,13,2416,16,4466,31
Central Michigan,Mid-American Conference,2018,12,1447,8,1614,10,3061,27
Charlotte,Conference USA,2018,12,1952,18,2166,10,4118,15
Cincinnati,American Athletic Conference,2018,13,3113,37,2847,22,5960,20
Clemson,Atlantic Coast Conference,2018,15,3740,49,4180,37,7920,17
Coastal Carolina,Sun Belt Conference,2018,12,2384,21,2168,19,4552,18
Colorado,Pac-12 Conference,2018,12,1716,21,2995,19,4711,19
Colorado State,Mountain West Conference,2018,12,1270,8,3659,26,4929,22
Connecticut,American Athletic Conference,2018,12,2395,16,2147,20,4542,28
Duke,Atlantic Coast Conference,2018,13,2075,19,3199,31,5274,20
East Carolina,American Athletic Conference,2018,12,1556,13,3417,18,4973,25
Eastern Michigan,Mid-American Conference,2018,13,1899,23,2947,21,4846,14
Florida,Southeastern Conference,2018,13,2773,23,2776,28,5549,14
Florida Atlantic,Conference USA,2018,12,2902,35,2844,14,5746,21
Florida International,Conference USA,2018,13,2296,27,3194,27,5490,13
Florida State,Atlantic Coast Conference,2018,12,1091,11,3229,20,4320,26
Fresno State,Mountain West Conference,2018,14,2169,31,3740,26,5909,14
Georgia,Southeastern Conference,2018,14,3349,30,3177,34,6526,14
Georgia Southern,Sun Belt Conference,2018,13,3469,35,1027,10,4496,5
Georgia State,Sun Belt Conference,2018,12,2069,21,2481,15,4550,18
Georgia Tech,Atlantic Coast Conference,2018,13,4226,45,1089,7,5315,17
Hawaii,Mountain West Conference,2018,14,1538,11,4344,43,5882,21
Houston,American Athletic Conference,2018,13,2815,29,3841,45,6656,19
Illinois,Big Ten Conference,2018,12,2937,25,1988,10,4925,24
Indiana,Big Ten Conference,2018,12,1888,17,3094,20,4982,21
Iowa,Big Ten Conference,2018,13,1929,19,2946,27,4875,18
Iowa State,Big 12 Conference,2018,13,1693,20,3132,20,4825,19
Kansas,Big 12 Conference,2018,12,1898,14,2312,18,4210,11
Kansas State,Big 12 Conference,2018,12,2191,20,1945,11,4136,17
Kent State,Mid-American Conference,2018,12,2061,20,2543,14,4604,20
Kentucky,Southeastern Conference,2018,13,2626,27,2099,14,4725,18
Liberty,Independent,2018,12,1937,30,3138,21,5075,24
Louisiana,Sun Belt Conference,2018,14,3063,31,2878,27,5941,17
Louisiana Tech,Conference USA,2018,13,1688,22,3244,16,4932,19
Louisiana-Monroe,Sun Belt Conference,2018,12,2008,22,2970,17,4978,23
Louisville,Atlantic Coast Conference,2018,12,1709,18,2533,10,4242,25
LSU,Southeastern Conference,2018,13,2257,29,2970,17,5227,13
Marshall,Conference USA,2018,13,2152,22,2965,20,5117,25
Maryland,Big Ten Conference,2018,12,2763,25,1695,12,4458,14
Massachusetts,Independent,2018,12,1677,22,3576,27,5253,24
Memphis,American Athletic Conference,2018,14,3919,48,3405,28,7324,17
Miami (FL),Atlantic Coast Conference,2018,13,2489,25,2175,19,4664,26
Miami (OH),Mid-American Conference,2018,12,1919,24,2547,17,4466,9
Michigan,Big Ten Conference,2018,13,2649,26,2804,24,5453,12
Michigan State,Big Ten Conference,2018,13,1623,14,2824,12,4447,22
Middle Tennessee State,Conference USA,2018,14,1804,15,3639,29,5443,20
Minnesota,Big Ten Conference,2018,13,2226,23,2714,20,4940,25
Mississippi State,Southeastern Conference,2018,13,2907,26,2259,22,5166,13
Missouri,Southeastern Conference,2018,13,2631,27,3632,28,6263,15
Navy,American Athletic Conference,2018,13,3596,37,947,5,4543,17
Nebraska,Big Ten Conference,2018,12,2508,25,2966,19,5474,22
Nevada,Mountain West Conference,2018,13,1979,24,3624,25,5603,28
Nevada-Las Vegas,Mountain West Conference,2018,12,2696,23,2002,24,4698,19
New Mexico,Mountain West Conference,2018,12,1838,17,2122,21,3960,26
New Mexico State,Independent,2018,12,1272,14,3182,16,4454,25
North Carolina,Atlantic Coast Conference,2018,11,2123,19,2740,14,4863,23
North Carolina State,Atlantic Coast Conference,2018,13,1860,27,4071,25,5931,18
North Texas,Conference USA,2018,13,1999,25,3988,28,5987,17
Northern Illinois,Mid-American Conference,2018,14,2337,17,2175,15,4512,20
Northwestern,Big Ten Conference,2018,14,1609,25,3352,17,4961,19
Notre Dame,Independent,2018,13,2378,27,3347,23,5725,17
Ohio,Mid-American Conference,2018,13,3363,40,2707,25,6070,19
Ohio State,Big Ten Conference,2018,14,2478,24,5022,50,7500,17
Oklahoma,Big 12 Conference,2018,14,3470,41,4520,43,7990,13
Oklahoma State,Big 12 Conference,2018,13,2479,30,4013,33,6492,22
Old Dominion,Conference USA,2018,12,1569,24,3564,21,5133,20
Ole Miss,Southeastern Conference,2018,12,1979,24,4157,21,6136,14
Oregon,Pac-12 Conference,2018,13,2351,28,3222,29,5573,17
Oregon State,Pac-12 Conference,2018,12,1867,23,2990,17,4857,18
Penn State,Big Ten Conference,2018,13,2663,34,2836,21,5499,21
Pitt,Atlantic Coast Conference,2018,14,3191,30,1985,12,5176,16
Purdue,Big Ten Conference,2018,13,1773,20,3998,28,5771,19
Rice,Conference USA,2018,13,1867,15,2272,13,4139,23
Rutgers,Big Ten Conference,2018,12,1609,12,1586,5,3195,29
San Diego State,Mountain West Conference,2018,13,2102,16,2433,14,4535,18
San Jose State,Mountain West Conference,2018,12,738,8,3131,21,3869,19
SMU,American Athletic Conference,2018,12,1387,17,3260,28,4647,14
South Alabama,Sun Belt Conference,2018,12,1824,17,2439,19,4263,22
South Carolina,Southeastern Conference,2018,13,1993,15,3547,32,5540,21
South Florida,American Athletic Conference,2018,13,2547,26,3152,17,5699,22
Southern Mississippi,Conference USA,2018,11,1239,11,2805,19,4044,23
Stanford,Pac-12 Conference,2018,13,1403,16,3550,29,4953,15
Syracuse,Atlantic Coast Conference,2018,13,2627,38,3441,22,6068,18
Temple,American Athletic Conference,2018,13,2052,28,3297,20,5349,25
Tennessee,Southeastern Conference,2018,12,1560,15,2357,15,3917,16
Texas,Big 12 Conference,2018,14,2153,24,3615,28,5768,11
Texas A&M,Southeastern Conference,2018,13,2847,28,3284,25,6131,17
Texas Christian,Big 12 Conference,2018,13,2044,14,2741,18,4785,26
Texas State,Sun Belt Conference,2018,12,1766,15,2188,15,3954,23
Texas Tech,Big 12 Conference,2018,12,1581,26,4231,28,5812,22
Toledo,Mid-American Conference,2018,13,2807,30,2963,32,5770,18
Troy,Sun Belt Conference,2018,13,2260,21,2799,25,5059,21
Tulane,American Athletic Conference,2018,13,2843,29,2380,15,5223,19
Tulsa,American Athletic Conference,2018,12,2422,23,2125,13,4547,22
UAB,Conference USA,2018,14,2819,32,2862,18,5681,19
UCF,American Athletic Conference,2018,13,3459,42,3347,29,6806,14
UCLA,Pac-12 Conference,2018,12,1863,20,2853,13,4716,17
USC,Pac-12 Conference,2018,12,1613,17,2978,18,4591,19
Utah,Pac-12 Conference,2018,14,2554,23,2995,19,5549,26
Utah State,Mountain West Conference,2018,13,2657,37,3825,32,6482,18
UTEP,Conference USA,2018,12,1484,17,2208,10,3692,28
UTSA,Conference USA,2018,12,1048,7,1918,9,2966,18
Vanderbilt,Southeastern Conference,2018,13,2179,22,3168,24,5347,14
Virginia,Atlantic Coast Conference,2018,13,2248,19,2751,26,4999,19
Virginia Tech,Atlantic Coast Conference,2018,13,2266,19,3300,29,5566,16
Wake Forest,Atlantic Coast Conference,2018,13,2817,21,3057,25,5874,19
Washington,Pac-12 Conference,2018,14,2468,25,3337,19,5805,17
Washington State,Pac-12 Conference,2018,13,1026,24,4856,39,5882,14
West Virginia,Big 12 Conference,2018,12,1931,22,4216,38,6147,17
Western Kentucky,Conference USA,2018,12,1640,15,2722,15,4362,17
Western Michigan,Mid-American Conference,2018,13,2598,32,3101,20,5699,19
Wisconsin,Big Ten Conference,2018,13,3554,32,2050,19,5604,24
Wyoming,Mountain West Conference,2018,12,2401,19,1576,8,3977,11
Air Force,Mountain West Conference,2019,13,3887,41,1602,14,5489,18
Akron,Mid-American Conference,2019,12,576,2,2342,12,2918,26
Alabama,Southeastern Conference,2019,13,2193,27,4449,49,6642,10
Appalachian State,Sun Belt Conference,2019,14,3248,35,2824,30,6072,9
Arizona,Pacific-12 Conference,2019,12,2089,19,3193,23,5282,18
Arizona State,Pacific-12 Conference,2019,13,1602,13,3235,21,4837,14
Arkansas,Southeastern Conference,2019,12,1767,14,2315,14,4082,21
Arkansas State,Sun Belt Conference,2019,13,1654,13,4057,37,5711,22
Army,Independent,2019,13,3863,45,1066,6,4929,18
Auburn,Southeastern Conference,2019,13,2592,31,2697,20,5289,17
Ball State,Mid-American Conference,2019,12,2655,27,2923,24,5578,16
Baylor,Big 12 Conference,2019,14,2330,35,3571,24,5901,19
Boise State,Mountain West Conference,2019,14,2347,27,3664,31,6011,19
Boston College,Atlantic Coast Conference,2019,13,3304,27,2288,20,5592,13
Bowling Green State,Mid-American Conference,2019,12,1950,15,1888,9,3838,21
Buffalo,Mid-American Conference,2019,13,3256,36,1795,14,5051,14
BYU,Independent,2019,13,2082,25,3701,20,5783,21
California,Pacific-12 Conference,2019,13,1716,16,2561,19,4277,13
Central Michigan,Mid-American Conference,2019,14,2562,36,3531,19,6093,30
Charlotte,Conference USA,2019,13,2649,26,2749,24,5398,18
Cincinnati,American Athletic Conference,2019,14,2912,30,2552,19,5464,20
Clemson,Atlantic Coast Conference,2019,15,3608,45,4325,40,7933,15
Coastal Carolina,Sun Belt Conference,2019,12,2351,24,2379,21,4730,17
Colorado,Pacific-12 Conference,2019,12,1804,14,2858,18,4662,14
Colorado State,Mountain West Conference,2019,12,1586,18,3663,21,5249,24
Connecticut,American Athletic Conference,2019,12,1547,13,2592,14,4139,22
Duke,Atlantic Coast Conference,2019,12,1804,16,2152,18,3956,28
East Carolina,American Athletic Conference,2019,12,1704,12,3466,22,5170,17
Eastern Michigan,Mid-American Conference,2019,13,1592,21,3681,27,5273,17
Florida,Southeastern Conference,2019,13,1690,21,3910,33,5600,18
Florida Atlantic,Conference USA,2019,14,2335,32,3956,30,6291,12
Florida International,Conference USA,2019,13,2160,23,2779,14,4939,15
Florida State,Atlantic Coast Conference,2019,13,1829,24,3479,24,5308,21
Fresno State,Mountain West Conference,2019,12,1916,27,2720,17,4636,18
Georgia,Southeastern Conference,2019,14,2602,21,3122,26,5724,13
Georgia Southern,Sun Belt Conference,2019,13,3286,29,968,9,4254,11
Georgia State,Sun Belt Conference,2019,13,3141,30,2577,22,5718,16
Georgia Tech,Atlantic Coast Conference,2019,12,1831,12,1607,14,3438,20
Hawaii,Mountain West Conference,2019,15,2021,21,5056,42,7077,30
Houston,American Athletic Conference,2019,12,2271,20,2440,19,4711,21
Illinois,Big Ten Conference,2019,13,1877,19,2409,19,4286,18
Indiana,Big Ten Conference,2019,13,1700,24,3931,24,5631,15
Iowa,Big Ten Conference,2019,13,1789,17,2976,16,4765,12
Iowa State,Big 12 Conference,2019,13,1733,22,4047,29,5780,16
Kansas,Big 12 Conference,2019,12,1756,10,2778,25,4534,20
Kansas State,Big 12 Conference,2019,13,2334,29,2352,12,4686,14
Kent State,Mid-American Conference,2019,13,2425,17,2849,24,5274,12
Kentucky,Southeastern Conference,2019,13,3628,36,1478,9,5106,20
Liberty,Independent,2019,13,1966,25,3756,29,5722,16
Louisiana,Sun Belt Conference,2019,14,3604,42,3314,27,6918,14
Louisiana Tech,Conference USA,2019,13,2189,27,3490,21,5679,19
Louisiana-Monroe,Sun Belt Conference,2019,12,2492,29,3041,21,5533,18
Louisville,Atlantic Coast Conference,2019,13,2780,23,3044,32,5824,19
LSU,Southeastern Conference,2019,15,2509,31,6024,61,8533,12
Marshall,Conference USA,2019,13,2515,21,2605,16,5120,18
Maryland,Big Ten Conference,2019,12,2033,23,2088,16,4121,21
Massachusetts,Independent,2019,12,1495,14,2022,15,3517,20
Memphis,American Athletic Conference,2019,14,2614,32,4177,33,6791,20
Miami (FL),Atlantic Coast Conference,2019,13,1537,16,3239,27,4776,17
Miami (OH),Mid-American Conference,2019,14,1852,22,2495,11,4347,18
Michigan,Big Ten Conference,2019,13,1966,26,3261,25,5227,20
Michigan State,Big Ten Conference,2019,13,1666,12,3182,17,4848,24
Middle Tennessee State,Conference USA,2019,12,2070,18,2837,22,4907,14
Minnesota,Big Ten Conference,2019,13,2323,25,3293,31,5616,15
Mississippi State,Southeastern Conference,2019,13,2869,27,2333,19,5202,23
Missouri,Southeastern Conference,2019,12,1820,14,2671,17,4491,14
Navy,American Athletic Conference,2019,13,4689,52,1238,10,5927,17
Nebraska,Big Ten Conference,2019,12,2454,27,2551,12,5005,21
Nevada,Mountain West Conference,2019,13,1505,16,3246,14,4751,24
Nevada-Las Vegas,Mountain West Conference,2019,12,2020,17,2474,20,4494,18
New Mexico,Mountain West Conference,2019,12,2464,20,2340,13,4804,26
New Mexico State,Independent,2019,12,1722,16,2611,15,4333,27
North Carolina,Atlantic Coast Conference,2019,13,2446,12,3716,39,6162,12
North Carolina State,Atlantic Coast Conference,2019,12,1817,14,2749,14,4566,21
North Texas,Conference USA,2019,12,1628,11,3400,33,5028,19
Northern Illinois,Mid-American Conference,2019,12,1696,15,2611,14,4307,19
Northwestern,Big Ten Conference,2019,12,2162,17,1404,6,3566,24
Notre Dame,Independent,2019,13,2327,20,3278,37,5605,11
Ohio,Mid-American Conference,2019,13,2883,36,2866,21,5749,19
Ohio State,Big Ten Conference,2019,14,3742,39,3684,48,7426,16
Oklahoma,Big 12 Conference,2019,14,3365,38,4164,36,7529,19
Oklahoma State,Big 12 Conference,2019,13,2985,27,2916,23,5901,20
Old Dominion,Conference USA,2019,12,1183,16,2117,5,3300,19
Ole Miss,Southeastern Conference,2019,12,3016,29,2328,11,5344,15
Oregon,Pacific-12 Conference,2019,14,2482,26,3615,35,6097,11
Oregon State,Pacific-12 Conference,2019,12,1884,21,3061,30,4945,6
Penn State,Big Ten Conference,2019,13,2496,34,2877,25,5373,14
Pitt,Atlantic Coast Conference,2019,13,1550,11,3402,17,4952,22
Purdue,Big Ten Conference,2019,12,1002,9,3719,29,4721,23
Rice,Conference USA,2019,12,1552,14,1992,13,3544,16
Rutgers,Big Ten Conference,2019,12,1612,11,1672,7,3284,23
San Diego State,Mountain West Conference,2019,13,1837,12,2634,15,4471,8
San Jose State,Mountain West Conference,2019,12,1079,19,4056,24,5135,13
SMU,American Athletic Conference,2019,13,2351,35,4017,34,6368,17
South Alabama,Sun Belt Conference,2019,12,2057,15,1906,14,3963,22
South Carolina,Southeastern Conference,2019,12,1796,18,2667,12,4463,14
South Florida,American Athletic Conference,2019,12,1938,15,2035,18,3973,19
Southern Mississippi,Conference USA,2019,13,1531,17,3764,20,5295,26
Stanford,Pacific-12 Conference,2019,12,1268,8,3149,18,4417,13
Syracuse,Atlantic Coast Conference,2019,12,1848,16,2887,23,4735,16
Temple,American Athletic Conference,2019,13,1791,16,3312,26,5103,20
Tennessee,Southeastern Conference,2019,13,1876,13,2878,19,4754,20
Texas,Big 12 Conference,2019,13,2303,25,3761,32,6064,14
Texas A&M,Southeastern Conference,2019,13,2077,23,3060,22,5137,20
Texas Christian,Big 12 Conference,2019,12,2448,23,2444,15,4892,20
Texas State,Sun Belt Conference,2019,12,920,8,2893,17,3813,24
Texas Tech,Big 12 Conference,2019,12,1795,20,3896,24,5691,15
Toledo,Mid-American Conference,2019,12,2703,27,2515,15,5218,19
Troy,Sun Belt Conference,2019,12,1743,19,3758,30,5501,18
Tulane,American Athletic Conference,2019,13,3181,33,2679,19,5860,18
Tulsa,American Athletic Conference,2019,12,1660,18,3376,20,5036,19
UAB,Conference USA,2019,14,2114,16,2815,20,4929,28
UCF,American Athletic Conference,2019,13,2923,34,4117,36,7040,15
UCLA,Pacific-12 Conference,2019,12,1802,18,3066,22,4868,22
USC,Pacific-12 Conference,2019,13,1537,18,4365,35,5902,26
Utah,Pacific-12 Conference,2019,14,2819,34,3187,20,6006,13
Utah State,Mountain West Conference,2019,13,2016,18,3628,22,5644,26
UTEP,Conference USA,2019,12,1721,18,2292,9,4013,14
UTSA,Conference USA,2019,12,1966,15,2189,13,4155,23
Vanderbilt,Southeastern Conference,2019,12,1521,11,2064,10,3585,13
Virginia,Atlantic Coast Conference,2019,14,1697,28,3740,23,5437,21
Virginia Tech,Atlantic Coast Conference,2019,13,2289,21,2718,22,5007,23
Wake Forest,Atlantic Coast Conference,2019,13,2284,18,3748,31,6032,17
Washington,Pacific-12 Conference,2019,13,1944,24,3164,24,5108,14
Washington State,Pacific-12 Conference,2019,13,885,12,5683,50,6568,25
West Virginia,Big 12 Conference,2019,12,881,7,2984,21,3865,20
Western Kentucky,Conference USA,2019,13,1670,18,3371,20,5041,21
Western Michigan,Mid-American Conference,2019,13,2666,35,3128,21,5794,14
Wisconsin,Big Ten Conference,2019,14,3272,38,2802,18,6074,22
Wyoming,Mountain West Conference,2019,13,2797,27,1770,11,4567,15
Air Force,Mountain West Conference,2020,6,1834,16,502,3,2336,8
Akron,Mid-American Conference,2020,6,849,7,838,4,1687,9
Alabama,Southeastern Conference,2020,12,2230,35,4192,37,6422,11
Appalachian State,Sun Belt Conference,2020,12,3182,28,2244,21,5426,17
Arizona,Pac-12 Conference,2020,5,782,4,1065,6,1847,12
Arizona State,Pac-12 Conference,2020,4,1057,16,777,5,1834,5
Arkansas,Southeastern Conference,2020,10,1513,11,2402,20,3915,13
Arkansas State,Sun Belt Conference,2020,11,1379,7,4008,39,5387,16
Army,Independent,2020,12,3273,36,537,4,3810,14
Auburn,Southeastern Conference,2020,11,1788,16,2423,12,4211,9
Ball State,Mid-American Conference,2020,8,1424,15,2164,17,3588,9
Baylor,Big 12 Conference,2020,9,813,8,1979,14,2792,9
Boise State,Mountain West Conference,2020,7,775,13,1693,12,2468,7
Boston College,Atlantic Coast Conference,2020,11,1119,11,3126,23,4245,14
Bowling Green State,Mid-American Conference,2020,5,920,5,712,1,1632,11
Buffalo,Mid-American Conference,2020,7,2010,32,1337,7,3347,6
BYU,Independent,2020,12,2297,34,3992,34,6289,8
California,Pac-12 Conference,2020,4,501,4,771,6,1272,5
Central Michigan,Mid-American Conference,2020,6,1309,16,1214,7,2523,9
Charlotte,Conference USA,2020,6,930,11,1337,10,2267,6
Cincinnati,American Athletic Conference,2020,10,2124,29,2386,20,4510,16
Clemson,Atlantic Coast Conference,2020,12,1846,33,4182,31,6028,15
Coastal Carolina,Sun Belt Conference,2020,12,2620,30,2778,29,5398,12
Colorado,Pac-12 Conference,2020,6,1274,15,1209,6,2483,11
Colorado State,Mountain West Conference,2020,4,496,6,798,4,1294,4
Duke,Atlantic Coast Conference,2020,11,1724,19,2441,11,4165,39
East Carolina,American Athletic Conference,2020,9,1564,11,2060,19,3624,21
Eastern Michigan,Mid-American Conference,2020,6,745,11,1657,12,2402,12
Florida,Southeastern Conference,2020,12,1575,12,4543,46,6118,19
Florida Atlantic,Conference USA,2020,9,1621,12,1300,8,2921,11
Florida International,Conference USA,2020,5,782,8,617,5,1399,4
Florida State,Atlantic Coast Conference,2020,9,1799,19,1771,10,3570,17
Fresno State,Mountain West Conference,2020,6,738,12,2138,14,2876,10
Georgia,Southeastern Conference,2020,10,1742,18,2499,19,4241,15
Georgia Southern,Sun Belt Conference,2020,13,3471,29,1355,9,4826,17
Georgia State,Sun Belt Conference,2020,10,1940,22,2303,18,4243,20
Georgia Tech,Atlantic Coast Conference,2020,10,1908,18,1991,14,3899,25
Hawaii,Mountain West Conference,2020,9,1375,15,2083,14,3458,12
Houston,American Athletic Conference,2020,8,1145,12,2126,15,3271,16
Illinois,Big Ten Conference,2020,8,1569,9,1223,10,2792,9
Indiana,Big Ten Conference,2020,8,894,12,2007,16,2901,12
Iowa,Big Ten Conference,2020,8,1368,18,1581,9,2949,9
Iowa State,Big 12 Conference,2020,12,2340,31,2896,20,5236,14
Kansas,Big 12 Conference,2020,9,944,9,1389,7,2333,14
Kansas State,Big 12 Conference,2020,10,1527,17,1857,12,3384,15
Kent State,Mid-American Conference,2020,4,1132,13,1294,14,2426,4
Kentucky,Southeastern Conference,2020,11,2155,19,1340,7,3495,12
Liberty,Independent,2020,11,2776,27,2524,25,5300,16
Louisiana,Sun Belt Conference,2020,11,2350,25,2290,20,4640,13
Louisiana Tech,Conference USA,2020,10,992,10,2166,21,3158,16
Louisiana-Monroe,Sun Belt Conference,2020,10,767,8,2290,14,3057,19
Louisville,Atlantic Coast Conference,2020,11,2200,21,2684,20,4884,24
LSU,Southeastern Conference,2020,10,1217,9,3122,24,4339,13
Marshall,Conference USA,2020,10,1784,18,2129,19,3913,12
Maryland,Big Ten Conference,2020,5,722,5,1320,9,2042,11
Massachusetts,Independent,2020,4,269,0,481,1,750,7
Memphis,American Athletic Conference,2020,11,1605,9,3387,31,4992,19
Miami (FL),Atlantic Coast Conference,2020,11,1788,18,3047,26,4835,12
Miami (OH),Mid-American Conference,2020,3,381,2,715,8,1096,2
Michigan,Big Ten Conference,2020,6,786,12,1502,9,2288,6
Michigan State,Big Ten Conference,2020,7,635,2,1672,11,2307,20
Middle Tennessee State,Conference USA,2020,9,1219,12,2074,13,3293,16
Minnesota,Big Ten Conference,2020,7,1343,19,1394,7,2737,7
Mississippi State,Southeastern Conference,2020,11,483,8,3259,17,3742,26
Missouri,Southeastern Conference,2020,10,1352,21,2668,9,4020,14
Navy,American Athletic Conference,2020,10,1777,15,974,6,2751,11
Nebraska,Big Ten Conference,2020,8,1611,15,1521,5,3132,18
Nevada,Mountain West Conference,2020,9,1101,7,2872,27,3973,9
Nevada-Las Vegas,Mountain West Conference,2020,6,868,7,1115,6,1983,9
New Mexico,Mountain West Conference,2020,7,1370,12,1386,8,2756,9
North Carolina,Atlantic Coast Conference,2020,12,2830,35,3617,31,6447,13
North Carolina State,Atlantic Coast Conference,2020,12,1481,20,3143,24,4624,19
North Texas,Conference USA,2020,10,2302,18,2830,28,5132,15
Northern Illinois,Mid-American Conference,2020,6,762,7,1443,11,2205,10
Northwestern,Big Ten Conference,2020,9,1465,16,1781,12,3246,15
Notre Dame,Atlantic Coast Conference,2020,12,2533,33,2848,15,5381,11
Ohio,Mid-American Conference,2020,3,650,8,438,4,1088,2
Ohio State,Big Ten Conference,2020,7,1908,17,1906,21,3814,9
Oklahoma,Big 12 Conference,2020,11,1977,27,3465,30,5442,14
Oklahoma State,Big 12 Conference,2020,11,2058,17,2630,18,4688,16
Ole Miss,Southeastern Conference,2020,10,2110,23,3449,30,5559,18
Oregon,Pac-12 Conference,2020,7,1167,13,1723,15,2890,16
Oregon State,Pac-12 Conference,2020,7,1383,15,1479,11,2862,8
Penn State,Big Ten Conference,2020,9,1569,15,2304,17,3873,17
Pitt,Atlantic Coast Conference,2020,11,1326,20,2857,14,4183,16
Purdue,Big Ten Conference,2020,6,489,4,1854,15,2343,7
Rice,Conference USA,2020,5,604,1,1076,11,1680,8
Rutgers,Big Ten Conference,2020,9,1259,13,1786,14,3045,14
San Diego State,Mountain West Conference,2020,8,1595,14,1211,6,2806,11
San Jose State,Mountain West Conference,2020,8,1073,8,2387,19,3460,9
SMU,American Athletic Conference,2020,10,1765,24,3180,23,4945,12
South Alabama,Sun Belt Conference,2020,11,1232,7,2719,18,3951,15
South Carolina,Southeastern Conference,2020,10,1679,21,1872,8,3551,15
South Florida,American Athletic Conference,2020,9,1339,11,1949,12,3288,17
Southern Mississippi,Conference USA,2020,10,1590,18,2130,12,3720,16
Stanford,Pac-12 Conference,2020,6,801,15,1720,7,2521,5
Syracuse,Atlantic Coast Conference,2020,11,1012,5,1906,15,2918,21
Temple,American Athletic Conference,2020,7,982,5,1456,11,2438,14
Tennessee,Southeastern Conference,2020,10,1415,12,2047,14,3462,15
Texas,Big 12 Conference,2020,10,1953,20,2801,32,4754,9
Texas A&M,Southeastern Conference,2020,10,2051,21,2341,20,4392,8
Texas Christian,Big 12 Conference,2020,10,2160,23,1963,11,4123,14
Texas State,Sun Belt Conference,2020,12,1583,15,2861,26,4444,18
Texas Tech,Big 12 Conference,2020,10,1634,17,2661,18,4295,19
Toledo,Mid-American Conference,2020,6,1009,8,1955,18,2964,12
Troy,Sun Belt Conference,2020,11,1129,11,3192,22,4321,18
Tulane,American Athletic Conference,2020,12,2611,32,2120,21,4731,14
Tulsa,American Athletic Conference,2020,9,1452,13,2276,15,3728,18
UAB,Conference USA,2020,9,1800,17,1812,14,3612,16
UCF,American Athletic Conference,2020,10,2107,23,3574,32,5681,10
UCLA,Pac-12 Conference,2020,7,1614,13,1571,18,3185,13
USC,Pac-12 Conference,2020,6,584,8,1916,17,2500,11
Utah,Pac-12 Conference,2020,5,970,9,1079,6,2049,13
Utah State,Mountain West Conference,2020,6,840,4,815,6,1655,10
UTEP,Conference USA,2020,8,1111,16,1674,7,2785,15
UTSA,Conference USA,2020,12,2591,24,2399,16,4990,12
Vanderbilt,Southeastern Conference,2020,9,991,4,1979,13,2970,17
Virginia,Atlantic Coast Conference,2020,10,1627,16,2606,22,4233,19
Virginia Tech,Atlantic Coast Conference,2020,11,2641,27,2207,13,4848,14
Wake Forest,Atlantic Coast Conference,2020,9,1468,22,2533,14,4001,7
Washington,Pac-12 Conference,2020,4,705,11,906,4,1611,3
Washington State,Pac-12 Conference,2020,4,517,8,1019,6,1536,8
West Virginia,Big 12 Conference,2020,10,1351,15,2775,16,4126,11
Western Kentucky,Conference USA,2020,12,1508,11,1984,12,3492,15
Western Michigan,Mid-American Conference,2020,6,1175,14,1703,18,2878,6
Wisconsin,Big Ten Conference,2020,7,1152,13,1267,10,2419,12
Wyoming,Mountain West Conference,2020,6,1317,16,920,1,2237,9
Air Force,Mountain West Conference,2021,13,4272,44,1242,8,5514,9
Akron,Mid-American Conference,2021,12,1490,8,2610,21,4100,17
Alabama,Southeastern Conference,2021,14,2213,21,4704,47,6917,12
Appalachian State,Sun Belt Conference,2021,14,2693,26,3489,29,6182,26
Arizona,Pac-12 Conference,2021,12,1544,6,2732,12,4276,23
Arizona State,Pac-12 Conference,2021,13,2530,34,2530,12,5060,22
Arkansas,Southeastern Conference,2021,13,2971,26,2781,22,5752,10
Arkansas State,Sun Belt Conference,2021,12,987,4,3757,27,4744,22
Army,Independent,2021,13,3654,46,1233,11,4887,8
Auburn,Southeastern Conference,2021,13,2098,22,3121,17,5219,12
Ball State,Mid-American Conference,2021,13,1704,17,2699,18,4403,12
Baylor,Big 12 Conference,2021,14,3073,29,2848,24,5921,15
Boise State,Mountain West Conference,2021,12,1486,15,3128,20,4614,15
Boston College,Atlantic Coast Conference,2021,12,2004,21,2192,13,4196,17
Bowling Green State,Mid-American Conference,2021,12,1242,15,2578,12,3820,17
Buffalo,Mid-American Conference,2021,12,2338,30,2589,12,4927,18
BYU,Independent,2021,13,2450,30,3433,26,5883,12
California,Pac-12 Conference,2021,12,1977,17,2659,16,4636,10
Central Michigan,Mid-American Conference,2021,13,2327,18,3434,31,5761,14
Charlotte,Conference USA,2021,12,1819,13,3033,27,4852,20
Cincinnati,American Athletic Conference,2021,14,2412,34,3377,29,5789,19
Clemson,Atlantic Coast Conference,2021,13,2203,26,2485,12,4688,19
Coastal Carolina,Sun Belt Conference,2021,13,2964,36,3457,33,6421,10
Colorado,Pac-12 Conference,2021,12,1515,12,1575,10,3090,7
Colorado State,Mountain West Conference,2021,12,1971,14,3022,15,4993,19
Connecticut,Independent,2021,12,1217,8,1966,11,3183,22
Duke,Atlantic Coast Conference,2021,12,2185,22,2855,9,5040,21
East Carolina,American Athletic Conference,2021,12,1940,20,3252,21,5192,22
Eastern Michigan,Mid-American Conference,2021,13,1533,26,3417,19,4950,14
Florida,Southeastern Conference,2021,13,2730,25,3303,26,6033,21
Florida Atlantic,Conference USA,2021,12,1843,18,2982,20,4825,18
Florida International,Conference USA,2021,12,1228,11,3182,20,4410,21
Florida State,Atlantic Coast Conference,2021,12,2128,21,2419,20,4547,21
Fresno State,Mountain West Conference,2021,13,1786,17,4247,35,6033,22
Georgia,Southeastern Conference,2021,14,2723,28,3554,37,6277,16
Georgia Southern,Sun Belt Conference,2021,12,2330,22,1765,5,4095,17
Georgia State,Sun Belt Conference,2021,13,2964,25,2101,19,5065,15
Georgia Tech,Atlantic Coast Conference,2021,12,2041,15,2373,18,4414,14
Hawaii,Mountain West Conference,2021,13,1857,22,3408,19,5265,29
Houston,American Athletic Conference,2021,14,1993,27,3802,32,5795,14
Illinois,Big Ten Conference,2021,12,2049,12,1874,13,3923,12
Indiana,Big Ten Conference,2021,12,1388,13,2106,9,3494,22
Iowa,Big Ten Conference,2021,14,1733,18,2521,12,4254,19
Iowa State,Big 12 Conference,2021,13,2092,25,3430,22,5522,14
Kansas,Big 12 Conference,2021,12,1699,15,2218,15,3917,13
Kansas State,Big 12 Conference,2021,13,2123,28,2589,14,4712,14
Kent State,Mid-American Conference,2021,14,3481,36,3444,21,6925,12
Kentucky,Southeastern Conference,2021,13,2597,27,2933,24,5530,23
Liberty,Independent,2021,13,2344,25,3315,33,5659,22
Louisiana,Sun Belt Conference,2021,14,2716,34,3060,22,5776,7
Louisiana Tech,Conference USA,2021,12,1468,16,3141,22,4609,23
Louisiana-Monroe,Sun Belt Conference,2021,12,1613,13,2328,15,3941,15
Louisville,Atlantic Coast Conference,2021,13,2733,29,3074,21,5807,13
LSU,Southeastern Conference,2021,13,1484,9,3307,32,4791,16
Marshall,Conference USA,2021,13,2109,38,3830,18,5939,25
Maryland,Big Ten Conference,2021,13,1774,20,3960,27,5734,18
Massachusetts,Independent,2021,12,1768,14,1840,11,3608,20
Memphis,American Athletic Conference,2021,12,1641,18,3585,26,5226,19
Miami (FL),Atlantic Coast Conference,2021,12,1545,20,3854,30,5399,17
Miami (OH),Mid-American Conference,2021,13,1923,15,3619,32,5542,12
Michigan,Big Ten Conference,2021,14,3001,39,3202,21,6203,14
Michigan State,Big Ten Conference,2021,13,2295,23,3298,27,5593,17
Middle Tennessee State,Conference USA,2021,13,1608,15,3100,28,4708,21
Minnesota,Big Ten Conference,2021,13,2589,27,2106,12,4695,13
Mississippi State,Southeastern Conference,2021,13,821,10,4918,37,5739,18
Missouri,Southeastern Conference,2021,13,2354,21,3024,18,5378,13
Navy,American Athletic Conference,2021,12,2723,19,681,6,3404,8
Nebraska,Big Ten Conference,2021,12,2168,31,3201,14,5369,18
Nevada,Mountain West Conference,2021,13,1007,13,4511,38,5518,11
Nevada-Las Vegas,Mountain West Conference,2021,12,1317,18,2430,11,3747,22
New Mexico,Mountain West Conference,2021,12,1448,5,1365,10,2813,20
New Mexico State,Independent,2021,12,1217,15,3233,15,4450,16
North Carolina,Atlantic Coast Conference,2021,13,2767,30,3324,26,6091,14
North Carolina State,Atlantic Coast Conference,2021,12,1519,11,3461,35,4980,10
North Texas,Conference USA,2021,13,3041,32,2562,12,5603,18
Northern Illinois,Mid-American Conference,2021,14,3381,36,2623,15,6004,18
Northwestern,Big Ten Conference,2021,12,1741,12,2128,13,3869,22
Notre Dame,Independent,2021,13,1863,23,3672,30,5535,15
Ohio,Mid-American Conference,2021,12,2249,20,2208,11,4457,16
Ohio State,Big Ten Conference,2021,13,2347,24,4952,46,7299,11
Oklahoma,Big 12 Conference,2021,13,2441,29,3429,32,5870,13
Oklahoma State,Big 12 Conference,2021,14,2597,27,3246,23,5843,21
Old Dominion,Conference USA,2021,13,2084,23,2788,14,4872,23
Ole Miss,Southeastern Conference,2021,13,2834,33,3567,21,6401,11
Oregon,Pac-12 Conference,2021,14,2824,35,3107,21,5931,14
Oregon State,Pac-12 Conference,2021,13,2786,33,2820,19,5606,18
Penn State,Big Ten Conference,2021,13,1401,11,3491,25,4892,15
Pitt,Atlantic Coast Conference,2021,14,2091,26,4723,44,6814,15
Purdue,Big Ten Conference,2021,13,1104,7,4620,35,5724,19
Rice,Conference USA,2021,12,1816,19,2540,16,4356,21
Rutgers,Big Ten Conference,2021,13,1798,20,2239,9,4037,14
San Diego State,Mountain West Conference,2021,14,2436,26,2390,16,4826,14
San Jose State,Mountain West Conference,2021,12,1457,12,2636,15,4093,24
SMU,American Athletic Conference,2021,12,1949,20,3654,39,5603,18
South Alabama,Sun Belt Conference,2021,12,1350,15,3075,22,4425,20
South Carolina,Southeastern Conference,2021,13,1799,9,2604,22,4403,23
South Florida,American Athletic Conference,2021,12,1898,25,2309,6,4207,21
Southern Mississippi,Conference USA,2021,12,1451,8,1746,14,3197,31
Stanford,Pac-12 Conference,2021,12,1047,13,2590,16,3637,19
Syracuse,Atlantic Coast Conference,2021,12,2572,28,1828,10,4400,12
Temple,American Athletic Conference,2021,12,1335,12,2114,10,3449,20
Tennessee,Southeastern Conference,2021,13,2827,30,3343,33,6170,13
Texas,Big 12 Conference,2021,12,2392,25,2705,29,5097,17
Texas A&M,Southeastern Conference,2021,12,2199,17,2503,19,4702,16
Texas Christian,Big 12 Conference,2021,12,2339,21,2838,19,5177,16
Texas State,Sun Belt Conference,2021,12,1797,15,2323,15,4120,19
Texas Tech,Big 12 Conference,2021,13,2070,30,3344,18,5414,20
Toledo,Mid-American Conference,2021,13,2561,29,3115,22,5676,7
Troy,Sun Belt Conference,2021,12,1214,18,2837,15,4051,21
Tulane,American Athletic Conference,2021,12,1979,19,2661,23,4640,25
Tulsa,American Athletic Conference,2021,13,2495,20,3242,18,5737,23
UAB,Conference USA,2021,13,2343,27,2683,20,5026,17
UCF,American Athletic Conference,2021,13,2556,27,2684,29,5240,15
UCLA,Pac-12 Conference,2021,12,2636,31,2714,23,5350,13
USC,Pac-12 Conference,2021,12,1744,16,3580,21,5324,20
Utah,Pac-12 Conference,2021,14,3038,37,3000,24,6038,15
Utah State,Mountain West Conference,2021,14,2038,13,4242,41,6280,22
UTEP,Conference USA,2021,13,1835,18,3283,18,5118,23
UTSA,Conference USA,2021,14,2574,26,3577,31,6151,13
Vanderbilt,Southeastern Conference,2021,12,1480,8,2272,12,3752,19
Virginia,Atlantic Coast Conference,2021,12,1464,21,4706,31,6170,18
Virginia Tech,Atlantic Coast Conference,2021,13,2409,16,2293,17,4702,12
Wake Forest,Atlantic Coast Conference,2021,14,2248,31,4303,39,6551,20
Washington,Pac-12 Conference,2021,12,1207,16,2700,15,3907,23
Washington State,Pac-12 Conference,2021,13,1582,19,3346,26,4928,18
West Virginia,Big 12 Conference,2021,13,1601,19,3223,19,4824,20
Western Kentucky,Conference USA,2021,14,1438,13,6072,63,7510,21
Western Michigan,Mid-American Conference,2021,13,2776,31,3297,23,6073,16
Wisconsin,Big Ten Conference,2021,13,2740,26,2082,11,4822,23
Wyoming,Mountain West Conference,2021,13,2746,24,2115,15,4861,18
Air Force,Mountain West Conference,2022,13,4247,37,916,8,5163,13
Akron,Mid-American Conference,2022,12,1075,16,3397,15,4472,26
Alabama,Southeastern Conference,2022,13,2542,26,3660,37,6202,17
Appalachian State,Sun Belt Conference,2022,12,2453,27,3011,28,5464,11
Arizona,Pac-12 Conference,2022,12,1722,19,3821,26,5543,21
Arizona State,Pac-12 Conference,2022,12,1623,21,3023,18,4646,18
Arkansas,Southeastern Conference,2022,13,3077,27,3051,26,6128,18
Arkansas State,Sun Belt Conference,2022,12,1058,16,2719,16,3777,9
Army,Independent,2022,12,3473,38,920,5,4393,13
Auburn,Southeastern Conference,2022,12,2470,25,2072,9,4542,24
Ball State,Mid-American Conference,2022,12,1868,14,2742,18,4610,21
Baylor,Big 12 Conference,2022,13,2371,34,3009,19,5380,17
Boise State,Mountain West Conference,2022,14,2746,27,2668,20,5414,17
Boston College,Atlantic Coast Conference,2022,12,758,6,2965,21,3723,26
Bowling Green,Mid-American Conference,2022,13,1270,8,3036,25,4306,23
Buffalo,Mid-American Conference,2022,13,1845,22,3059,18,4904,18
BYU,Independent,2022,13,2296,19,3246,32,5542,10
California,Pac-12 Conference,2022,12,1159,10,3216,23,4375,12
Central Michigan,Mid-American Conference,2022,12,1910,22,2497,16,4407,28
Charlotte,Conference USA,2022,12,1393,13,3252,27,4645,21
Cincinnati,American Athletic Conference,2022,13,1686,19,3155,22,4841,16
Clemson,Atlantic Coast Conference,2022,14,2491,31,3253,24,5744,22
Coastal Carolina,Sun Belt Conference,2022,13,2071,22,3200,27,5271,20
Colorado,Pac-12 Conference,2022,12,1300,11,2075,10,3375,22
Colorado State,Mountain West Conference,2022,12,1068,4,2361,12,3429,20
Connecticut,Independent,2022,13,2483,20,1459,10,3942,22
Duke,Atlantic Coast Conference,2022,13,2394,31,3010,20,5404,10
East Carolina,American Athletic Conference,2022,13,2218,25,3776,28,5994,7
Eastern Michigan,Mid-American Conference,2022,13,1830,25,2911,23,4741,19
Florida,Southeastern Conference,2022,13,2603,29,2910,18,5513,14
Florida Atlantic,Conference USA,2022,12,2212,19,2726,25,4938,13
Florida International,Conference USA,2022,12,1260,11,2625,16,3885,22
Florida State,Atlantic Coast Conference,2022,13,2783,33,3512,28,6295,14
Fresno State,Mountain West Conference,2022,14,1851,28,3788,22,5639,14
Georgia,Southeastern Conference,2022,15,3080,44,4437,31,7517,18
Georgia Southern,Sun Belt Conference,2022,13,1779,23,4283,28,6062,21
Georgia State,Sun Belt Conference,2022,12,2561,26,2443,18,5004,20
Georgia Tech,Atlantic Coast Conference,2022,12,1592,13,2306,10,3898,13
Hawaii,Mountain West Conference,2022,13,1784,16,2672,13,4456,20
Houston,American Athletic Conference,2022,13,1844,17,4082,40,5926,19
Illinois,Big Ten Conference,2022,13,2161,18,2753,15,4914,17
Indiana,Big Ten Conference,2022,12,1330,15,2609,16,3939,18
Iowa,Big Ten Conference,2022,13,1234,12,2037,7,3271,17
Iowa State,Big 12 Conference,2022,12,1296,10,3141,19,4437,22
James Madison,Sun Belt Conference,2022,11,2054,24,2923,27,4977,20
Kansas,Big 12 Conference,2022,13,2395,29,3307,32,5702,19
Kansas State,Big 12 Conference,2022,14,2916,32,2947,21,5863,12
Kent State,Mid-American Conference,2022,12,2425,23,2582,17,5007,13
Kentucky,Southeastern Conference,2022,13,1511,9,2710,21,4221,19
Liberty,Independent,2022,13,2245,24,2817,21,5062,27
Louisiana,Sun Belt Conference,2022,13,1845,10,2893,27,4738,19
Louisiana Tech,Conference USA,2022,12,1497,14,3207,25,4704,25
Louisiana-Monroe,Sun Belt Conference,2022,12,1448,16,2464,16,3912,15
Louisville,Atlantic Coast Conference,2022,13,2608,25,2672,13,5280,24
LSU,Southeastern Conference,2022,14,2574,39,3770,23,6344,19
Marshall,Sun Belt Conference,2022,13,2677,20,2496,16,5173,19
Maryland,Big Ten Conference,2022,13,1837,23,3383,21,5220,15
Massachusetts,Independent,2022,12,1786,10,1403,4,3189,20
Memphis,American Athletic Conference,2022,13,1849,30,3629,23,5478,16
Miami (FL),Atlantic Coast Conference,2022,12,1537,12,2868,18,4405,25
Miami (OH),Mid-American Conference,2022,13,1821,14,2152,15,3973,13
Michigan,Big Ten Conference,2022,14,3345,41,3078,24,6423,10
Michigan State,Big Ten Conference,2022,12,1356,16,2880,23,4236,17
Middle Tennessee State,Conference USA,2022,13,1411,20,3442,21,4853,18
Minnesota,Big Ten Conference,2022,13,2695,33,2369,12,5064,13
Mississippi State,Southeastern Conference,2022,13,1062,12,4046,36,5108,19
Missouri,Southeastern Conference,2022,13,2031,20,2778,14,4809,21
Navy,American Athletic Conference,2022,12,2894,22,1028,9,3922,16
Nebraska,Big Ten Conference,2022,12,1480,17,2650,17,4130,19
Nevada,Mountain West Conference,2022,12,1421,19,2227,7,3648,17
Nevada-Las Vegas,Mountain West Conference,2022,12,1645,18,2580,15,4225,15
New Mexico,Mountain West Conference,2022,12,1478,12,1259,3,2737,14
New Mexico State,Independent,2022,13,2099,25,2199,18,4298,19
North Carolina,Atlantic Coast Conference,2022,14,2149,24,4330,38,6479,14
North Carolina State,Atlantic Coast Conference,2022,13,1479,8,2939,23,4418,16
North Texas,Conference USA,2022,14,2798,24,3667,34,6465,22
Northern Illinois,Mid-American Conference,2022,12,2285,19,2192,18,4477,16
Northwestern,Big Ten Conference,2022,12,1501,11,2524,10,4025,31
Notre Dame,Independent,2022,13,2458,25,2692,25,5150,18
Ohio,Mid-American Conference,2022,14,2003,23,3894,28,5897,13
Ohio State,Big Ten Conference,2022,13,2501,30,3878,42,6379,10
Oklahoma,Big 12 Conference,2022,13,2852,28,3310,27,6162,15
Oklahoma State,Big 12 Conference,2022,13,1632,20,3634,24,5266,24
Old Dominion,Sun Belt Conference,2022,12,1107,8,2966,19,4073,19
Ole Miss,Southeastern Conference,2022,13,3336,33,3117,22,6453,21
Oregon,Pac-12 Conference,2022,13,2805,34,3702,30,6507,12
Oregon State,Pac-12 Conference,2022,13,2554,36,2594,16,5148,18
Penn State,Big Ten Conference,2022,13,2354,28,3283,29,5637,15
Pitt,Atlantic Coast Conference,2022,13,2379,30,2896,13,5275,20
Purdue,Big Ten Conference,2022,14,1694,17,3903,26,5597,23
Rice,Conference USA,2022,13,1839,17,3028,23,4867,32
Rutgers,Big Ten Conference,2022,12,1533,11,1847,11,3380,20
San Diego State,Mountain West Conference,2022,13,1864,11,2360,15,4224,25
San Jose State,Mountain West Conference,2022,12,1149,19,3270,23,4419,9
SMU,American Athletic Conference,2022,13,2030,26,4117,36,6147,20
South Alabama,Sun Belt Conference,2022,13,2038,19,3470,28,5508,16
South Carolina,Southeastern Conference,2022,13,1545,27,3380,23,4925,27
South Florida,American Athletic Conference,2022,12,2375,25,2315,18,4690,20
Southern Mississippi,Sun Belt Conference,2022,13,1843,15,2687,20,4530,26
Stanford,Pac-12 Conference,2022,12,1288,14,3051,15,4339,22
Syracuse,Atlantic Coast Conference,2022,13,1852,21,3020,19,4872,14
Temple,American Athletic Conference,2022,12,989,11,3217,18,4206,23
Tennessee,Southeastern Conference,2022,13,2593,40,4239,38,6832,11
Texas,Big 12 Conference,2022,13,2446,29,3138,22,5584,12
Texas A&M,Southeastern Conference,2022,12,1698,12,2633,18,4331,17
Texas Christian,Big 12 Conference,2022,15,2899,37,3926,33,6825,16
Texas State,Sun Belt Conference,2022,12,1249,9,2653,19,3902,17
Texas Tech,Big 12 Conference,2022,13,2066,28,3966,26,6032,26
Toledo,Mid-American Conference,2022,14,2487,23,3144,31,5631,26
Troy,Sun Belt Conference,2022,14,1638,21,3400,20,5038,21
Tulane,American Athletic Conference,2022,14,2867,34,3312,30,6179,16
Tulsa,American Athletic Conference,2022,12,1664,18,3278,27,4942,18
UAB,Conference USA,2022,13,3055,32,2634,15,5689,18
UCF,American Athletic Conference,2022,14,3197,35,3377,22,6574,23
UCLA,Pac-12 Conference,2022,13,3084,36,3463,29,6547,21
USC,Pac-12 Conference,2022,14,2396,30,4696,43,7092,7
Utah,Pac-12 Conference,2022,14,3047,38,3489,31,6536,18
Utah State,Mountain West Conference,2022,13,2069,14,2537,18,4606,27
UTEP,Conference USA,2022,12,2006,14,2612,15,4618,21
UTSA,Conference USA,2022,14,2454,28,4210,34,6664,20
Vanderbilt,Southeastern Conference,2022,12,1919,13,2248,22,4167,20
Virginia,Atlantic Coast Conference,2022,10,1231,13,2210,7,3441,22
Virginia Tech,Atlantic Coast Conference,2022,11,1212,15,2236,9,3448,15
Wake Forest,Atlantic Coast Conference,2022,13,1696,17,4055,43,5751,19
Washington,Pac-12 Conference,2022,13,1898,33,4807,32,6705,11
Washington State,Pac-12 Conference,2022,13,1389,17,3300,24,4689,18
West Virginia,Big 12 Conference,2022,12,2058,24,2730,20,4788,19
Western Kentucky,Conference USA,2022,14,2031,15,4931,43,6962,22
Western Michigan,Mid-American Conference,2022,12,1635,14,1988,10,3623,21
Wisconsin,Big Ten Conference,2022,13,2337,21,2390,21,4727,18
Wyoming,Mountain West Conference,2022,13,2358,16,1719,11,4077,16
